"filename", "language", "C++", "comment", "blank", "total"
"c:\Projects\Penguine\penguine_core\include\app.h", "C++", 3, 0, 3, 6
"c:\Projects\Penguine\penguine_core\include\entity\tickable.h", "C++", 1, 0, 2, 3
"c:\Projects\Penguine\penguine_core\include\entity\viewable.h", "C++", 9, 0, 3, 12
"c:\Projects\Penguine\penguine_core\include\event.h", "C++", 0, 1, 0, 1
"c:\Projects\Penguine\penguine_core\include\global.h", "C++", 23, 2, 13, 38
"c:\Projects\Penguine\penguine_core\include\render\camera.h", "C++", 1, 0, 1, 2
"c:\Projects\Penguine\penguine_core\include\render\mesh.h", "C++", 18, 0, 5, 23
"c:\Projects\Penguine\penguine_core\include\render\shader.h", "C++", -1, 0, 0, -1
"c:\Projects\Penguine\penguine_core\include\render\texture.h", "C++", 10, 0, 3, 13
"c:\Projects\Penguine\penguine_core\include\resource.h", "C++", 15, 0, 6, 21
"c:\Projects\Penguine\penguine_core\include\scene.h", "C++", 1, 0, 2, 3
"c:\Projects\Penguine\penguine_core\include\window.h", "C++", 0, 1, 0, 1
"Total", "-", 80, 4, 38, 122